border_size=1
usage=map

Gs^Fp       , Gs^Fp       , Gs^Fp       , Gs^Fp       , Gs^Fp       , Gs^Fp       , Gs^Fp       , Hh          , Hh          , Wo          , Hh^Fp       , Hh^Fp       , Hh^Fp       , Hh^Fp       , Hh^Fp       , Ss          , Ww          , Gs^Ft       , Gs^Ft       , Gs^Ft       , Gs^Ft       , Gs^Ft       , Gs^Ft       , Gs^Ft       , Ss          , Ww          , Hh^Fmf      , Hh^Fmw      , Hh^Fmw      , Hh^Fmw      , Hh^Fmw      , Hh^Fmw      , Hh^Fmw      , Hh^Fmw      , Hh^Fmw      , Hh^Fmw      , Hh^Fmw      
Gs^Fp       , Gs^Fp       , Hh^Fdw      , Hh^Fdw      , Hh^Fdw      , Hh^Fdw      , Hh          , Hh          , Hh^Fdw      , Wo          , Hh^Fp       , Hh^Fp       , Hh^Fp       , Hh^Fp       , Hh^Fp       , Ss          , Ss          , Ww          , Ww          , Gs^Ft       , Gs^Ft       , Gs^Ft       , Gs^Ft       , Ss          , Ww          , Ww          , Chw         , Hh^Fmw      , Hh^Fmw      , Hh^Fmw      , Ww          , Hh^Fmw      , Chs         , Chs         , Chs         , Hh^Fmw      , Hh^Fmw      
Gs^Fp       , Gs^Fp       , Wo          , Hh^Fdw      , Chs         , Hh^Fdw      , Hh          , Hh          , Hh          , Wo          , Hh^Fp       , Hh^Fp       , Hh^Fp       , Hh^Fp       , Hh^Fp       , Hh^Fp       , Hh^Fp       , Ss          , Ww          , Gs^Ft       , Gs^Ft       , Gs^Ft       , Ss          , Ss          , Ww          , Chw         , 4 Khs       , Hh^Fmw      , Ww          , Ww          , Ss          , Ww          , Chw         , Kv          , Chs         , Hh^Fmw      , Hh^Fmw      
Gs^Fp       , Gs^Fp       , Hh^Fdw      , Chw         , Khs         , Ch          , Hh          , Hh^Fdw      , Hh          , Wo          , Wo          , Hh^Fp       , Hh^Fp       , Hh^Fp       , Hh^Fp       , Hh^Fp       , Hh^Fp       , Ss          , Ss          , Ww          , Gs^Ft       , Gs^Ft       , Ss          , Ww          , Hh^Fdf      , Chw         , Hh^Fmw      , Hh^Fmw      , Ww          , Ss          , Hh^Fmw      , Ss          , Hh^Fmw      , Chs         , Re          , Hh^Fmw      , Re          
Gs^Fp       , Gs^Fp       , Hh^Fdw      , Chs         , Ch          , Chr         , Hh          , Hh          , Hh          , Hh          , Wo^Bw\      , Hh^Fp       , Hh^Fp       , Hh^Fp       , Hh^Fp       , Hh^Fp       , Ss          , Ss          , Ww          , Ww          , Gs^Ft       , Ss          , Ww          , Ww          , Ww          , Hh^Fmf      , Ww          , Ww          , Ss          , Ss          , Hh^Fmw      , Hh^Fmw      , Hh^Fmw      , Re          , 1 Hh^Fmw    , Re          , Hh^Fmw      
Gs^Fp       , Gs^Fp       , Gs^Fp       , Hh^Fdw      , Hh^Fdw      , Re          , Hh          , Hh          , Hh          , Wo          , Hh^Fp       , Hh^Fp       , Hh^Fp       , Hh^Fp       , Hh^Fp       , Hh^Fp       , Ss          , Ww          , Gs^Ft       , Gs^Ft       , Ss          , Ww          , Ss          , Ss          , Ss          , Ww          , Ss          , Ss          , Hh^Fmw      , Hh^Fmw      , Hh^Fmw      , Hh^Fmw      , Hh^Fdw      , Hh^Fmw      , Hh^Fmw      , Hh^Fmw      , Hh^Fmw      
Gs^Fp       , Gs^Fp       , Gs^Fp       , Hh^Fdw      , Re          , Re          , Hh^Fdw      , Hh^Fdw      , Hh          , Wo          , Hh^Fp       , Hh^Fp       , Hh          , Hh^Fp       , Ss          , Ss          , Ww          , Ww          , Gs^Ft       , Gs^Ft       , Ss          , Ww          , Ss          , Hh^Fmw      , Hh^Fmw      , Ss          , Hh^Fmw      , Hh^Fmw      , Hh^Fdw      , Hh^Fdw      , Hh^Fdw      , Hh^Fmw      , Hh          , Hh^Fmw      , Hh^Fmw      , Hh^Fmw      , Hh^Fmw      
Gs^Fp       , Gs^Fp       , Gs^Fp       , Gs^Fp       , Re          , Hh^Fdw      , Hh^Fp       , Hh^Fdw      , Wo          , Wo          , Hh^Fp       , Hh^Fp       , Hh^Fp       , Hh^Fp       , Ss          , Ww          , Gs^Ft       , Gs^Ft       , Gs^Ft       , Gs^Ft       , Ss          , Ww          , Ww          , Hh^Fmw      , Hh^Fmw      , Hh^Fmw      , Hh^Fdw      , Hh^Fdw      , Hh^Fdw      , Hh^Fdw      , Hh^Fmw      , Hh          , Hh^Fmw      , Hh          , Hh          , Hh^Fdw      , Hh^Fmw      
Gs^Fp       , Gs^Fp       , Gs^Fp       , Re          , Re          , Gs^Fp       , Gs^Fp       , Gs^Fp       , Wo          , Hh^Fp       , Hh^Fp       , Hh^Fp       , Hh^Fp       , Ss          , Ww          , Ww          , Gs^Ft       , Gs^Ft       , Gs^Ft       , Gs^Ft       , Ss          , Ww          , Hh^Fmw      , Hh^Fmw      , Hh^Fdw      , Hh^Fdw      , Hh^Fdw      , Hh^Fdw      , Hh^Fdw      , Hh^Fdw      , Hh^Fdw      , Hh          , Hh          , Hh^Fmw      , Hh^Fmw      , Hh^Fdw      , Hh^Fmw      
Gs^Fp       , Gs^Fp       , Gs^Fp       , Re          , Gs^Fp       , Gs^Fp       , Gs^Fp       , Gs^Fp       , Wo          , Gs^Fp       , Hh^Fp       , Hh^Fp       , Ss          , Ss          , Ww          , Gs^Ft       , Gs^Ft       , Gs^Ft       , Gs^Ft       , Gs^Ft       , Ss          , Ww          , Ss          , Hh^Fmw      , Hh^Fmw      , Hh^Fmw      , Hh^Fmw      , Hh^Fdw      , Hh^Fdw      , Hh^Fdw      , Hh^Fdw      , Hh^Fdw      , Hh^Fdw      , Hh^Fmw      , Hh          , Hh^Fmw      , Hh          
Gs^Fp       , Gs^Fp       , Gs^Fp       , Re          , Re          , Gs^Fp       , Gs^Fp       , Wo          , Wo          , Gs^Fp       , Ss          , Ss          , Ww          , Ww          , Ss          , Ss          , Ss          , Ss          , Ss          , Ss          , Ss          , Ww          , Ww          , Ss          , Ss          , Ss          , Ss          , Hh^Fmw      , Hh^Fmw      , Hh^Fdw      , Hh^Fdw      , Hh          , Hh          , Hh^Fdw      , Hh^Fdw      , Hh^Fmw      , Hh          
Gs^Fp       , Hh^Fdf      , Re          , Gs^Fp       , Re          , Gs^Fp       , Re          , Re          , Wo          , Gs^Fp       , Ss          , Ss          , Ww          , Ww          , Uu^Uf       , Uu^Uf       , Ss          , Ss          , Ss          , Ss          , Ss          , Ww          , Ww          , Ss          , Ss          , Ss          , Ss          , Hh^Fdw      , Hh^Fmw      , Hh^Fdw      , Hh^Fdw      , Hh^Fdw      , Hh^Fdw      , Hh^Fdw      , Hh          , Hh          , Hh^Fmw      
Re          , Re          , Re          , Re          , Chr         , Re          , Re          , Re          , Ss          , Ss          , Ww          , Ww          , Ss          , Ss          , Ss          , Ww          , Ww          , Ss          , Ss          , Ss          , Ss          , Ss          , Ss          , Ww          , Ss          , Ss          , Ss          , Hh^Fmw      , Hh^Fmw      , Hh          , Hh^Fdw      , Hh          , Hh^Fmw      , Hh^Fmw      , Hh^Fmw      , Hh^Fmw      , Hh^Fmw      
Re          , Re          , Gg          , Chr         , 3 Khr       , Chs         , Gg          , Ss          , Ss          , Ss          , Ww          , Ss          , Ss          , Ss^Vhs      , Gg          , Ss          , Ww          , Ss          , Ss          , Ss          , Ss          , Ss          , Ss          , Ww          , Ww          , Ss          , Ss          , Hh^Fmw      , Hh^Fdw      , Hh^Fdw      , Hh^Fmw      , Hh^Fmw      , Hh          , Hh^Fdw      , Re          , Re          , Hh^Fmw      
Ss          , Ss          , Gg          , Chs         , Chr         , Chr         , Ss          , Gg^Vl       , Ss          , Ss          , Ss          , Ss          , Gg          , Gg          , Gg          , Ss          , Ww          , Ss          , Ss          , Ss          , Gg          , Gg          , Ss          , Ss          , Ss          , Ww          , Ww          , Ss          , Ss          , Hh^Fmw      , Hh^Fmw      , Hh^Fdw      , Re          , Re          , Hh^Fdw      , Re          , Hh^Fmw      
Ss          , Ss          , Ss          , Gg          , Gg          , Gg          , Gg          , Ww          , Wwf         , Ww          , Gg          , Ss          , Gg          , Re          , Re          , Gg          , Wwf         , Gg          , Gg          , Ss          , Ss          , Gg          , Gg          , Ss          , Ss^Vm       , Ss          , Ss          , Ww          , Ww          , Ss          , Re          , Re          , Hh^Fdw      , Hh^Fdw      , Hh^Fdw      , Hh^Fdw      , Hh^Fmw      
Ww          , Ww          , Ww          , Gg^Vl       , Gg          , Ww          , Ww          , Wwf         , Gg          , Gg          , Re          , Gg          , Gg          , Re          , Gg          , Gg          , Ww          , Gg          , Gg          , Ss^Vm       , Ss          , Ss          , Ss          , Ss          , Gg          , Gg          , Gg          , Ss          , Re          , Re          , Ww          , Ss          , Ss          , Ss          , Ss          , Hh^Fmw      , Hh^Fmw      
Ss          , Ss          , Gg          , Ww          , Gg          , Gg          , Ss          , Ww          , Ss          , Gg          , Gg          , Gg          , Ss          , Gg          , Ss          , Ss          , Ss          , Ss          , Ss          , Gg          , Ss          , Ss          , Ss          , Gg          , Gg          , Gg          , Re          , Gg          , Gg          , Ss          , Ss          , Ww          , Ww          , Ww          , Ww          , Ss          , Ss          
Ss          , Ss          , Ww          , Ww          , Ss          , Ss          , Ss          , Ww          , Ww          , Ss          , Gg          , Gg          , Ss          , Ss          , Ss          , Ww          , Ss          , Ss          , Gg          , Uu^Uf       , Ss          , Gg          , Ss          , Ss          , Gg          , Re          , Gg          , Gg          , Gg          , Gg          , Gg          , Ss          , Ss          , Ww          , Ww          , Ww          , Ww          
Ss          , Ss          , Ss          , Ww          , Ww          , Ss          , Ss          , Ss          , Ww          , Ss          , Gg          , Ss          , Ss          , Ss          , Ss          , Ww          , Ss          , Ss          , Ss          , Gg          , Ss          , Ss          , Ss          , Ss          , Ss          , Re          , Ss          , Ss          , Ss          , Gg          , Ss          , Ss          , Ww          , Ww          , Ww          , Ww          , Ww          
Gg          , Gg          , Ss          , Ss          , Ss          , Ww          , Ww          , Ww          , Ss          , Ww          , Wwf         , Gg          , Ss          , Ss          , Ww          , Ww          , Ww          , Ss          , Ss          , Ss          , Ss          , Ss^Vm       , Gg          , Gg          , Re          , Re          , Ss          , Ss          , Ss          , Ss          , Ss          , Ww          , Gg          , Gg          , Gg          , Ww          , Ww          
Ss          , Ss          , Gg          , Ss          , Gg          , Ss          , Ss          , Ww          , Ss          , Gg          , Ss          , Ww          , Ww          , Ww          , Ss          , Ss          , Ss          , Ss          , Ss          , Ss          , Ss          , Gg          , Gs^Fp       , Re          , Gs^Fp       , Gg          , Ss          , Ss          , Ss          , Ss          , Ss          , Ss          , Ss          , Ss          , Ss          , Gg          , Gg          
Ss          , Ss          , Ss          , Ss          , Gg          , Gg          , Ss          , Ww          , Ss          , Gg          , Gg          , Gg          , Gg          , Ww          , Ss          , Ss          , Ss          , Ww          , Ss          , Ss          , Gg          , Gg          , Gs^Fp       , Re          , Gs^Fp       , Gs^Fp       , Gs^Fdw      , Ss          , Ss          , Ss          , Ss          , Ss          , Ss          , Ss          , Ss          , Ss          , Ss          
Gg          , Gg          , Ss^Vhs      , Ss          , Ss          , Ss          , Ss          , Ww          , Ss          , Gg          , Ss          , Gg          , Gg          , Ww          , Ss          , Wwf         , Ss          , Ss          , Ss          , Gg          , Re          , Re          , Re          , Re          , Gs^Fp       , Gs^Fp       , Gs^Fp       , Gs^Fdw      , Gs^Fdw      , Ss          , Gs^Fdw      , Gg          , Gg          , Ss          , Ss          , Ss          , Ss          
Gg          , Gg          , Ss          , Ss          , Ss          , Ss          , Ww          , Ww          , Ss          , Ss          , Ss          , Gg          , Wwf         , Ww          , Ko          , Ss          , Ss          , Wo          , Ss          , Ss          , Ww          , Gg          , Gg          , Gg          , Gg          , Gs^Fp       , Gg          , Gg          , Ss          , Gs^Fdw      , Ss          , Gs^Fdw      , Ss          , Ss          , Ss          , Ss          , Ss          
Gg          , Gg          , Gg          , Gg          , Ss          , Ww          , Ww          , Ww          , Ss          , Ww          , Ss          , Ss          , Ss          , Ww          , Ss          , Ss          , Re          , 2 Re        , Ss          , Ko^Dr       , Ss          , Ww          , Ss          , Ss^Vhs      , Ss          , Gg          , Ss          , Ss          , Ss          , Ss          , Ss          , Ss          , Ss          , Ss          , Ss          , Ss          , Ss          
Gs^Fp       , Gs^Fp       , Gs^Fp       , Gg          , Gg          , Ww          , Ww          , Ww          , Gg          , Ss          , Ss          , Ww          , Ww          , Ss          , Ss          , Ss          , Re          , Hh          , Hh          , Hh          , Hh^Dr       , Ss          , Ww          , Ss          , Ss          , Ss          , Ss          , Ss          , Ss          , Ss          , Ss          , Ss          , Ss          , Ss          , Ss          , Ss          , Ss          
Gs^Fp       , Gs^Fp       , Gg          , Gs^Fp       , Gg          , Ww          , Ww          , Ww          , Ss          , Gg          , Ss          , Ss          , Ww          , Ss          , Hh          , Ss          , Re          , Hh          , Ss          , Hh          , Ss          , Ss          , Ss          , Ss          , Ww          , Ww          , Ss          , Ss          , Ss          , Ss          , Ss          , Ss          , Ss          , Ss          , Ss          , Ss          , Ss          
Re          , Re          , Re          , Ggf         , Gs^Fp       , Gg          , Gg          , Ww          , Ss          , Ss          , Ggf         , Ss          , Ww          , Ss          , Ss          , Re          , Ss          , Ss          , Ss          , Wo          , Ss          , Ss          , Ww          , Ww          , Ss          , Ss          , Ss          , Ss          , Ss          , Ss          , Ss          , Ss          , Ss          , Ss          , Ss          , Ss          , Ss          
Gg          , Gg          , Gg          , Re          , Re          , Gg          , Gs^Fp       , Gg          , Gg          , Ss          , Gg          , Wwf         , Re          , Ss          , Ww          , Ss          , Ss          , Ss^Vm       , Ss          , Re          , Ss          , Ss          , Ww          , Ss          , Wwf         , Ss^Vm       , Ss          , Ss          , Ss          , Ss          , Ss          , Ss          , Ss          , Ss          , Ss          , Ss          , Ss          
Hh          , Hh          , Hh^Fdw      , Gg          , Gs^Fp       , Re          , Re          , Gs^Fp       , Re          , Gg          , Re          , Re          , Wwf         , Wwf         , Ss          , Ww          , Ww          , Re          , Re          , Re          , Re          , Ww          , Ss          , Ss          , Re          , Re          , Re          , Ss          , Re          , Ss          , Ss          , Ss          , Re          , Ss          , Ss          , Ss          , Re          
Hh          , Hh          , Gg          , Gg          , Gg          , Gs^Fp       , Gg          , Re          , Gs^Fp       , Re          , Gg          , Gg          , Ss          , Ss          , Ss          , Ss          , Ww          , Ss          , Ss          , Re          , Re          , Re          , Re          , Ss          , Ss          , Ss          , Ss          , Re          , Ss          , Re          , Re          , Re          , Re          , Ss          , Re          , Re          , Ss          
Gg          , Hh^Fdw      , Gg          , Gg          , Hh^Fdw      , Hh^Fdw      , Gg          , Re          , Gs^Fp       , Gs^Fp       , Gs^Fp       , Gg          , Wwf         , Ss          , Wwf         , Ss          , Ss          , Ww          , Ww          , Ww          , Ss          , Re          , Re          , Re          , Ss          , Re          , Ss          , Ss          , Ss          , Ss          , Ss          , Ss          , Ss          , Ss          , Ss          , Ss          , Ss          
Gg          , Gg          , Gg          , Hh^Fdw      , Hh^Fdw      , Hh^Fdw      , Gg          , Re          , Re          , Gs^Fp       , Gg          , Gg          , Ss          , Ss          , Wwf         , Ss          , Ss          , Ww          , Wo          , Ww          , Wwf         , Ss          , Re          , Re          , Re          , Ss          , Ss          , Ss          , Ss          , Ss          , Ss          , Ss          , Ss          , Ss          , Ss          , Ss          , Ss          
Hh          , Hh          , Hh^Fdw      , Hh^Fdw      , Hh^Fdw      , Hh^Fdw      , Gg          , Gs^Fp       , Re          , Gg          , Gs^Fp       , Gg          , Wwf         , Ss          , Ss          , Ss          , Ww          , Ww          , Ww          , Wwf         , Ss          , Ss          , Chs         , Chs         , Ss          , Ss          , Ss          , Ss          , Ss          , Ss          , Ss          , Ss          , Ss          , Ss          , Ss          , Ss          , Ss          
Hh          , Hh          , Hh          , Hh^Fdw      , Gg          , Gg          , Gg^Vo       , Gg          , Re          , Gg          , Gs^Fp       , Gg          , Gg          , Ss          , Ss          , Ss          , Ww          , Wo          , Ww          , Ss          , Ss          , Ch          , Chw         , Ss          , Chw         , Chs         , Ss          , Ss          , Ss          , Ss          , Ss          , Ss          , Ss          , Ss          , Ss          , Ss          , Ss          
Hh          , Hh          , Hh          , Gg          , Gg          , Gg          , Gg          , Gg          , Re          , Gg          , Gs^Fp       , Gg          , Gg          , Ss          , Ss          , Ss          , Ww          , Wo          , Ww          , Ss          , Ss          , Ss          , Ss          , Ss          , Gg          , Ss          , Ss          , Ss          , Ss          , Ss          , Ss          , Ss          , Ss          , Ss          , Ss          , Ss          , Ss          
